###############################################################
#          #                                                  #
#          #                                                  #
#          #                                                  #
#          #    ########################                      #
#          #                           #                      #
#          #                           ##################     #
#          #                                                  #
#          #                                                  #
#          #                                                  #
#          #                           #     ##################
#          #                           #                      #
#          #############################                      #
#                                                             #
#                                                             #
#                                                             #
#                                       #######################
#                                                              
###############################################################