###############################################################
#                                                             #
#                                                             #
#                                                             #
#          #############################                      #
#          #                           #                      #
#          #                           #                      #
#          #                           #                      #
#          #                           #                      #
#          #                           #                      #
#          #                           #                      #
#          #                           #                      #
#          #############################                      #
#                                                             #
#                                                             #
#                                                             #
#                                                             #
#                                                              
###############################################################