#########################################################################
#                    #                                                  #
#                    #                                                  #
#                    #                                                  #
#                    #    ########################                      #
#                    #                           #                      #
#                    #                           ##################     #
#                    #                                                  #
#                    #                                                  #
#                    #                                                  #
#                    #                           #     ##################
#                    #                           #                      #
#                    #############################                      #
#                                                                       #
#                                                                       #
#                                                                       #
#                                                 #######################
#                                                                       #
#                                                                       #
#                                                                       #
#                                                                       #
#                                                                       #
#                                                                       #
#                                                                       #
#########################################################################