###############################################################
#                                                              
#                                           ###################
#     #######################################                 #
#                                           #                 #
#                                                             #
########################################                      #
#                                                             #
#                                           #                 #
#     #######################################                 #
#                                           #                 #
#########################################   ###################
#                                           #                 #
#    ########################################                 #
#                                                             #
#############################################                 #
#                                                             #
#p                                                            #
###############################################################