###############################################################
#                                                              
#                                                             #
#                                                             #
#                                                             #
#         #                                                   #
#                                                             #
#                                                             #
#                                                             #
#                                                             #
#                                                             #
#                                                             #
#                                                             #
#                                       #                     #
#                                                             #
#                                                             #
#                                                             #
#                                                             #
###############################################################