###############################################################
#                                                             #
#                                                             #
#                                                             #
#                               #                             #
#                                                             #
#                                                             #
#                                                             #
#                                                             #
#                                                             #
#                                                             #
#                #                                            #
#                                                             #
#                                                             #
#                                                             #
#                                                             #
#                               #                             #
#                                                             #
###############################################################