###############################################################
#                   #############                             #
#                   #############                             #
##############                  #                             #
#                               #                             #
#                               #                             #
#                ################                             #
#                #              #                             #
#                #              #       #                     #
#                #              #########                     #
#                #                                            #
#                #                                            #
#                #              ###                           #
#                ###########    #                             #
#                               #                             #
#                               #                             #
#                               #                             #
#                               #                             #
###############################################################